i milan level
##########
#G  V   S#
##########

i 0
##########
#G    #  #
##### #  #
#   #  H #
## #### ##
#   #    #
#S#V  ##V#
##########

i 2
######
#G   #
#### #
#  S #
# ####
#    #
######

