i easy first level
##########
#G  V   S#
##########

i 1
##########
#G       #
#  V     #
#   V    #
#    H   #
#     V  #
#      V #
#       S#
##########

i 2
######
#G   #
#### #
#   V#
# ####
#SV  #
######

i 0
##########
#G    #  #
##### #  #
#   #  H #
## #### ##
#   #    #
#S#V  ##V#
##########

i 5
##########
# #G# # ##
#  V  # H#
#### #  ##
# #   #  #
#S  #  # #
##########

